Veolia: VEOEY
3M: MMM
A. O. Smith: AOS
Abbott: ABT
AbbVie: ABBV
Accenture: ACN
Adobe Inc.: ADBE
Advanced Micro Devices: AMD
AES Corporation: AES
Aflac: AFL
Agilent Technologies: A
Air Products and Chemicals: APD
Airbnb: ABNB
Akamai: AKAM
Albemarle Corporation: ALB
Alexandria Real Estate Equities: ARE
Align Technology: ALGN
Allegion: ALLE
Alliant Energy: LNT
Allstate: ALL
Alphabet Inc. (Class A): GOOGL
Alphabet Inc. (Class C): GOOG
Altria: MO
Amazon: AMZN
Amcor: AMCR
Ameren: AEE
American Airlines Group: AAL
American Electric Power: AEP
American Express: AXP
American International Group: AIG
American Tower: AMT
American Water Works: AWK
Ameriprise Financial: AMP
Ametek: AME
Amgen: AMGN
Amphenol: APH
Analog Devices: ADI
Ansys: ANSS
Aon: AON
APA Corporation: APA
Apple Inc.: AAPL
Applied Materials: AMAT
Aptiv: APTV
Arch Capital Group: ACGL
Archer-Daniels-Midland: ADM
Arista Networks: ANET
Arthur J. Gallagher & Co.: AJG
Assurant: AIZ
AT&T: T
Atmos Energy: ATO
Autodesk: ADSK
Automatic Data Processing: ADP
AutoZone: AZO
AvalonBay Communities: AVB
Avery Dennison: AVY
Axon Enterprise: AXON
Baker Hughes: BKR
Ball Corporation: BALL
Bank of America: BAC
Bank of New York Mellon: BK
Bath & Body Works, Inc.: BBWI
Baxter International: BAX
Becton Dickinson: BDX
Berkshire Hathaway: BRK.B
Best Buy: BBY
Bio-Rad: BIO
Bio-Techne: TECH
Biogen: BIIB
BlackRock: BLK
Blackstone: BX
Boeing: BA
Booking Holdings: BKNG
BorgWarner: BWA
Boston Properties: BXP
Boston Scientific: BSX
Bristol Myers Squibb: BMY
Broadcom Inc.: AVGO
Broadridge Financial Solutions: BR
Brown & Brown: BRO
Brown–Forman: BF.B
Builders FirstSource: BLDR
Bunge Global SA: BG
Cadence Design Systems: CDNS
Caesars Entertainment: CZR
Camden Property Trust: CPT
Campbell Soup Company: CPB
Capital One: COF
Cardinal Health: CAH
CarMax: KMX
Carnival: CCL
Carrier Global: CARR
Catalent: CTLT
Caterpillar Inc.: CAT
Cboe Global Markets: CBOE
CBRE Group: CBRE
CDW: CDW
Celanese: CE
Cencora: COR
Centene Corporation: CNC
CenterPoint Energy: CNP
CF Industries: CF
CH Robinson: CHRW
Charles River Laboratories: CRL
Charles Schwab Corporation: SCHW
Charter Communications: CHTR
Chevron Corporation: CVX
Chipotle Mexican Grill: CMG
Chubb Limited: CB
Church & Dwight: CHD
Cigna: CI
Cincinnati Financial: CINF
Cintas: CTAS
Cisco: CSCO
Citigroup: C
Citizens Financial Group: CFG
Clorox: CLX
CME Group: CME
CMS Energy: CMS
Coca-Cola Company (The): KO
Cognizant: CTSH
Colgate-Palmolive: CL
Comcast: CMCSA
Comerica: CMA
Conagra Brands: CAG
ConocoPhillips: COP
Consolidated Edison: ED
Constellation Brands: STZ
Constellation Energy: CEG
CooperCompanies: COO
Copart: CPRT
Corning Inc.: GLW
Corpay: CPAY
Corteva: CTVA
CoStar Group: CSGP
Costco: COST
Coterra: CTRA
Crown Castle: CCI
CSX: CSX
Cummins: CMI
CVS Health: CVS
Danaher Corporation: DHR
Darden Restaurants: DRI
DaVita Inc.: DVA
Dayforce: DAY
Deckers Brands: DECK
John Deere: DE
Delta Air Lines: DAL
Devon Energy: DVN
Dexcom: DXCM
Diamondback Energy: FANG
Digital Realty: DLR
Discover Financial: DFS
Dollar General: DG
Dollar Tree: DLTR
Dominion Energy: D
Domino's: DPZ
Dover Corporation: DOV
Dow Inc.: DOW
DR Horton: DHI
DTE Energy: DTE
Duke Energy: DUK
DuPont: DD
Eastman Chemical Company: EMN
Eaton Corporation: ETN
eBay: EBAY
Ecolab: ECL
Edison International: EIX
Edwards Lifesciences: EW
Electronic Arts: EA
Elevance Health: ELV
Eli Lilly and Company: LLY
Emerson Electric: EMR
Enphase: ENPH
Entergy: ETR
EOG Resources: EOG
EPAM Systems: EPAM
EQT Corporation: EQT
Equifax: EFX
Equinix: EQIX
Equity Residential: EQR
Essex Property Trust: ESS
Estée Lauder Companies (The): EL
Etsy: ETSY
Everest Re: EG
Evergy: EVRG
Eversource: ES
Exelon: EXC
Expedia Group: EXPE
Expeditors International: EXPD
Extra Space Storage: EXR
ExxonMobil: XOM
F5, Inc.: FFIV
FactSet: FDS
Fair Isaac: FICO
Fastenal: FAST
Federal Realty: FRT
FedEx: FDX
Fidelity National Information Services: FIS
Fifth Third Bank: FITB
First Solar: FSLR
FirstEnergy: FE
Fiserv: FI
FMC Corporation: FMC
Ford Motor Company: F
Fortinet: FTNT
Fortive: FTV
Fox Corporation (Class A): FOXA
Fox Corporation (Class B): FOX
Franklin Templeton: BEN
Freeport-McMoRan: FCX
Garmin: GRMN
Gartner: IT
GE Aerospace: GE
GE HealthCare: GEHC
GE Vernova: GEV
Gen Digital: GEN
Generac: GNRC
General Dynamics: GD
General Mills: GIS
General Motors: GM
Genuine Parts Company: GPC
Gilead Sciences: GILD
Global Payments: GPN
Globe Life: GL
Goldman Sachs: GS
Halliburton: HAL
Hartford (The): HIG
Hasbro: HAS
HCA Healthcare: HCA
Healthpeak: DOC
Henry Schein: HSIC
Hershey's: HSY
Hess Corporation: HES
Hewlett Packard Enterprise: HPE
Hilton Worldwide: HLT
Hologic: HOLX
Home Depot (The): HD
Honeywell: HON
Hormel Foods: HRL
Host Hotels & Resorts: HST
Howmet Aerospace: HWM
HP Inc.: HPQ
Hubbell Incorporated: HUBB
Humana: HUM
Huntington Bancshares: HBAN
Huntington Ingalls Industries: HII
IBM: IBM
IDEX Corporation: IEX
Idexx Laboratories: IDXX
Illinois Tool Works: ITW
Illumina: ILMN
Incyte: INCY
Ingersoll Rand: IR
Insulet: PODD
Intel: INTC
Intercontinental Exchange: ICE
International Flavors & Fragrances: IFF
International Paper: IP
Interpublic Group of Companies (The): IPG
Intuit: INTU
Intuitive Surgical: ISRG
Invesco: IVZ
Invitation Homes: INVH
IQVIA: IQV
Iron Mountain: IRM
J.B. Hunt: JBHT
Jabil: JBL
Jack Henry & Associates: JKHY
Jacobs Solutions: J
Johnson & Johnson: JNJ
Johnson Controls: JCI
JPMorgan Chase: JPM
Juniper Networks: JNPR
Kellanova: K
Kenvue: KVUE
Keurig Dr Pepper: KDP
KeyCorp: KEY
Keysight: KEYS
Kimberly-Clark: KMB
Kimco Realty: KIM
Kinder Morgan: KMI
KLA Corporation: KLAC
Kraft Heinz: KHC
Kroger: KR
L3Harris: LHX
LabCorp: LH
Lam Research: LRCX
Lamb Weston: LW
Las Vegas Sands: LVS
Leidos: LDOS
Lennar: LEN
Linde plc: LIN
Live Nation Entertainment: LYV
LKQ Corporation: LKQ
Lockheed Martin: LMT
Loews Corporation: L
Lowe's: LOW
Lululemon Athletica: LULU
LyondellBasell: LYB
M&T Bank: MTB
Marathon Oil: MRO
Marathon Petroleum: MPC
MarketAxess: MKTX
Marriott International: MAR
Marsh McLennan: MMC
Martin Marietta Materials: MLM
Masco: MAS
Mastercard: MA
Match Group: MTCH
McCormick & Company: MKC
McDonald's: MCD
McKesson Corporation: MCK
Medtronic: MDT
Merck & Co.: MRK
Meta Platforms: META
MetLife: MET
Mettler Toledo: MTD
MGM Resorts: MGM
Microchip Technology: MCHP
Micron Technology: MU
Microsoft: MSFT
Mid-America Apartment Communities: MAA
Moderna: MRNA
Mohawk Industries: MHK
Molina Healthcare: MOH
Molson Coors Beverage Company: TAP
Mondelez International: MDLZ
Monolithic Power Systems: MPWR
Monster Beverage: MNST
Moody's Corporation: MCO
Morgan Stanley: MS
Mosaic Company (The): MOS
Motorola Solutions: MSI
MSCI: MSCI
Nasdaq, Inc.: NDAQ
NetApp: NTAP
Netflix: NFLX
Newmont: NEM
News Corp (Class A): NWSA
News Corp (Class B): NWS
NextEra Energy: NEE
Nike, Inc.: NKE
NiSource: NI
Nordson Corporation: NDSN
Norfolk Southern Railway: NSC
Northern Trust: NTRS
Northrop Grumman: NOC
Norwegian Cruise Line Holdings: NCLH
NRG Energy: NRG
Nucor: NUE
Nvidia: NVDA
NVR, Inc.: NVR
NXP Semiconductors: NXPI
O'Reilly Auto Parts: ORLY
Occidental Petroleum: OXY
Old Dominion: ODFL
Omnicom Group: OMC
ON Semiconductor: ON
ONEOK: OKE
Oracle Corporation: ORCL
Otis Worldwide: OTIS
Paccar: PCAR
Packaging Corporation of America: PKG
Palo Alto Networks: PANW
Paramount Global: PARA
Parker Hannifin: PH
Paychex: PAYX
Paycom: PAYC
PayPal: PYPL
Pentair: PNR
PepsiCo: PEP
Pfizer: PFE
PG&E Corporation: PCG
Philip Morris International: PM
Phillips 66: PSX
Pinnacle West: PNW
PNC Financial Services: PNC
Pool Corporation: POOL
PPG Industries: PPG
PPL Corporation: PPL
Principal Financial Group: PFG
Procter & Gamble: PG
Progressive Corporation: PGR
Prologis: PLD
Prudential Financial: PRU
Public Service Enterprise Group: PEG
PTC: PTC
Public Storage: PSA
PulteGroup: PHM
Qorvo: QRVO
Quanta Services: PWR
Qualcomm: QCOM
Quest Diagnostics: DGX
Ralph Lauren Corporation: RL
Raymond James: RJF
RTX Corporation: RTX
Realty Income: O
Regency Centers: REG
Regeneron: REGN
Regions Financial Corporation: RF
Republic Services: RSG
ResMed: RMD
Revvity: RVTY
Robert Half: RHI
Rockwell Automation: ROK
Rollins, Inc.: ROL
Roper Technologies: ROP
Ross Stores: ROST
Royal Caribbean Group: RCL
S&P Global: SPGI
Salesforce: CRM
SBA Communications: SBAC
Schlumberger: SLB
Seagate Technology: STX
Sempra Energy: SRE
ServiceNow: NOW
Sherwin-Williams: SHW
Simon Property Group: SPG
Skyworks Solutions: SWKS
J.M. Smucker Company (The): SJM
Snap-on: SNA
Solventum: SOLV
Southern Company: SO
Southwest Airlines: LUV
Stanley Black & Decker: SWK
Starbucks: SBUX
State Street Corporation: STT
Steel Dynamics: STLD
Steris: STE
Stryker Corporation: SYK
Supermicro: SMCI
Synchrony Financial: SYF
Synopsys: SNPS
Sysco: SYY
T-Mobile US: TMUS
T. Rowe Price: TROW
Take-Two Interactive: TTWO
Tapestry, Inc.: TPR
Targa Resources: TRGP
Target Corporation: TGT
TE Connectivity: TEL
Teledyne Technologies: TDY
Teleflex: TFX
Teradyne: TER
Tesla, Inc.: TSLA
Texas Instruments: TXN
Textron: TXT
Thermo Fisher Scientific: TMO
TJX Companies: TJX
Tractor Supply: TSCO
Trane Technologies: TT
TransDigm Group: TDG
Travelers Companies (The): TRV
Trimble Inc.: TRMB
Truist: TFC
Tyler Technologies: TYL
Tyson Foods: TSN
U.S. Bank: USB
Uber: UBER
UDR, Inc.: UDR
Ulta Beauty: ULTA
Union Pacific Corporation: UNP
United Airlines Holdings: UAL
United Parcel Service: UPS
United Rentals: URI
UnitedHealth Group: UNH
Universal Health Services: UHS
Valero Energy: VLO
Ventas: VTR
Veralto: VLTO
Verisign: VRSN
Verisk: VRSK
Verizon: VZ
Vertex Pharmaceuticals: VRTX
Viatris: VTRS
Vici Properties: VICI
Visa Inc.: V
Vistra: VST
Vulcan Materials Company: VMC
W. R. Berkley Corporation: WRB
W. W. Grainger: GWW
Wabtec: WAB
Walgreens Boots Alliance: WBA
Walmart: WMT
Walt Disney Company (The): DIS
Warner Bros. Discovery: WBD
Waste Management: WM
Waters Corporation: WAT
WEC Energy Group: WEC
Wells Fargo: WFC
Welltower: WELL
West Pharmaceutical Services: WST
Western Digital: WDC
WestRock: WRK
Weyerhaeuser: WY
Williams Companies: WMB
Willis Towers Watson: WTW
Wynn Resorts: WYNN
Xcel Energy: XEL
Xylem Inc.: XYL
Yum! Brands: YUM
Zebra Technologies: ZBRA
Zimmer Biomet: ZBH
Zoetis: ZTS
